########S######
#             #
###         ###
##### #########
####      #####
####### #######
###         ###
#####     #####
###           #
#####E#########