##S############
#             #
##### #########
###           #
#####E#########