###############
#             #
##### #########
###       S####
#####E#########